11111111111111111
10010000000000001
10000111110000001
100011E0000000001
10000C00100000001
10000001P10000001
1001110C000000001
10010000000000001
11111111111111111
